206
Iwan Barnard - Martins, Haaris
Yasser Benjamin - H Martins
Dewi French - Iwan Barnard
Haaris Martins - Yasser Benjamin
Affan Wharton - Shannan
Shannan Weir - A Wharton
Julius Wood - Shannan
Saanvi Macfarlane - Shola Ramos
Israr Deacon - Shola
Shola Ramos - I Deacon
Hana Park - Kaylan
Kaylan Shaw - Joyce
Sulayman Busby - Kaylan Shaw
Joyce Lim - Kaylan
Buddy Odling - Hana
Madelaine Dale - Pickett, Ayrton
Dianne Bevan - Mullen, Nate
Halimah Lister - Dale, Madelaine
Olaf Aldred - d bevan
Ayrton Pickett - Aldred, Olaf
Nate Mullen - briony
Briony Colley - Halimah Lister
Chandni Whitfield - Abbott, Kaiden
Diego Melia - C Cruz
RubyLeigh Stanton - Cecily Cruz
Maverick Braun - D Melia
Kaiden Abbott - R Stanton
Simone Townsend - Hutton, Varun
Varun Hutton - R Stanton
Cecily Cruz - Maverick Braun
Mimi Nielsen - JIMMY VASQUEZ
Jimmy Vasquez - Yara Gomez
Yara Gomez - MIMI NIELSEN
Huey Reed - Fenella
Martin Harris - E Curran
Fenella Chadwick - Martin Harris
Elleanor Curran - Fenella
Hoorain Stein - Tia
Imaani Esquivel - g mccartney
Gurveer Mccartney - Preston, Tia
Yaseen Osborn - Preston, Tia
Tia Preston - I Esquivel
Adinaly Drummond - Danyl
Rowena Richmond - CAITLIN ROSARIO
Maci Parra - Rosario, Caitlin
Danyl Phillips - Caitlin Rosario
Caitlin Rosario - M Parra
Jolie Jenkins - Rea
Rea Blundell - H Villanueva
Raheem Marsh - Villanueva, Harry
Silas Steadman - Jenkins, Jolie
Ivo Francis - Jenkins, Jolie
Harry Villanueva - SIlAS sTeAdman
Avaya Buck - C Millington
Tasnim Kenny - Havin
Havin Daly - Millington, Camden
Clive Bannister - C Millington
Camden Millington - H Daly
Erica Whitehead - Houghton, Lara
LillyAnn Carson - Briana
Nylah Snyder - LillyAnn Carson
Tianna Lyon - Williamson, Briana
Briana Williamson - Erica
Lara Houghton - Nylah Snyder
Angelika Sullivan - Bush, Milo
Eryn Wang - Angelika
Milo Bush - Eryn Wang
Ahsan Mcpherson - Rico
Alby Robinson - A Mcpherson
Melisa Leal - a robinson
Rico Snider - Robinson, Alby
Maximus Frey - David, Ann
Zackery Reid - A David
Ann David - Reid, Zackery
Brandon Stevens - Octavia
Octavia Hope - Shaquille
Shaquille Morley - Hope, Octavia
Bronwin Whitaker - Robyn
Eve William - Brooks, Aiysha
Aiysha Brooks - A Coombes
Lucy Whittington - D Foley
Declan Foley - Whittington, Lucy
Annie Coombes - R Kaiser
Robyn Kaiser - A Coombes
Agata Jordan - Annie Coombes
Nusaybah Mccray - K Ingram
Jimmie Thornton - S POTTS
Kayne Ingram - Jimmie
Sue Potts - Nusaybah Mccray
Ewan Johns - MANNING, FATMA
Edgar Bean - E Johns
Kian Guzman - Goff, Ajwa
Ajwa Goff - E Bean
Fatma Manning - Ewan Johns
Tobias Holland - Bean, Edgar
Mylo Arias - alanah
Misha Riddle - Mylo
Alanah Muir - Misha Riddle
Codey Rosas - Derry Craig
Derry Craig - Alanah Muir
Ocean Gilmour - m RIDDLE
Emilee Reader - Rochelle Oneil
Ana Lutz - Dunkley, Madeeha
Orlando Lewis - E Reader
Calum Mcintyre - Ana Lutz
Rochelle Oneil - oRlanDO lEWIs
Nettie Chapman - Emilee
Madeeha Dunkley - N Chapman
Syeda Bains - Madeeha Dunkley
Herbie Casey - Coleman, Kacie
Kacie Coleman - Howells, Rojin
Rojin Howells - Herbie
Asia Bloom - J Mclaughlin
Kayleigh Sears - Asia
Selena Cairns - Palmer, Sarah
Sarah Palmer - Tazmin
Fahad Driscoll - A Bloom
Jadine Mclaughlin - Asia Bloom
Tazmin Ruiz - Bloom, Asia
Colm Burt - B Owen
Alyssia Sweet - Warner, OliviaMae
Courtney Tang - BillieJo
Bushra Owen - OliviaMae Warner
OliviaMae Warner - Alyssia Sweet
BillieJo Sharples - O Warner
Markus Montoya - Sadler, Lori
Efe Franks - Obrien, Jerrod
Sameer Petersen - Jerrod
Cyrus Andrade - L Sadler
Nabila Hopkins - Sadler, Lori
Jerrod Obrien - Markus Montoya
Lori Sadler - Efe Franks
Norman Bruce - Markus Montoya
Zaina Rahman - rojas, ariya
Sade Mcmillan - rahman, zaina
Barnaby Mcclain - S Mcmillan
Ariya Rojas - S Mcmillan
Yusef Holding - Menaal
Steven Cuevas - brOnwEn Morris
Bronwen Morris - Menaal Beck
Menaal Beck - Y Holding
Reo Cartwright - Ziggy Forbes
Ayush Mendoza - Leona
Ziggy Forbes - Wright, Leona
Zakariah Arellano - Reo Cartwright
Leona Wright - Zakariah
AnnMarie Stewart - Meyer, Ricardo
Jackson Vickers - R Meyer
Zayaan Leach - Reeve, Zachariah
Nabeela Mcfadden - AnnMarie
Ricardo Meyer - Jackson Vickers
Zachariah Reeve - Leach, Zayaan
Maksymilian Hutchinson - Doyle, Adina
Kaylem Welch - L Byrne
Iestyn Buchanan - Adina Doyle
Adina Doyle - J Zimmerman
Janine Zimmerman - KAylEm
Leoni Byrne - Doyle, Adina
Usama Buxton - Buchanan, Iestyn
Safiya Churchill - Delarosa, Yousef
Lisa Aguirre - Yousef
Kerys Cano - Yousef Delarosa
Dilan Mckeown - Y Delarosa
Yousef Delarosa - Kerys
Clodagh Beaumont - Marwa Vaughan
Cohan Harding - Vaughan, Marwa
Marwa Vaughan - Clodagh Beaumont
MiaRose Santiago - Cara
Cara Melendez - M Santiago
Kynan Pratt - Melendez, Cara
Kaycee Prentice - Mcghee, Ruby
Chad Plant - Elisabeth Conley
Mikaela Young - Chad Plant
Nabiha Riley - mikaela young
Ruby Mcghee - E Conley
Elisabeth Conley - Nabiha Riley
Devan Mcgrath - Ruby Mcghee
Brook Emery - L Vo
Liya Vo - Azaan Sosa
Harri Noel - Liya Vo
Azaan Sosa - Liya Vo
Bridget Zhang - Love, Walid
Vicky Stuart - B Zhang
Walid Love - b zhANg
Keeleigh Little - C Redfern
Kaylen Everett - Jensen, Caden
Abu Vargas - Redfern, Che
Zahrah Silva - Emma Sheehan
Derren Downs - Keeleigh
Che Redfern - cAdEN jEnSEn
Emma Sheehan - Caden
Caden Jensen - Kaylen
SummerLouise Banks - Ammaarah Lin
Harper Rosa - Roberts, Sasha
Nazia Clements - RoBErTS, SaShA
Agatha Duggan - Banks, SummerLouise
Ammaarah Lin - H Rosa
Sasha Roberts - Rosa, Harper
Cleveland Skinner - Z Schofield
Zoya Schofield - C Skinner
